XXXXXXXXXXXXXXXXXXXXXXXXXXXXXXXXXXXXXXXXXXXXXXXXXXXXXXXXXXXXXXXXXXXXXXXXXXXXXXXXX
P         X         X   X         X       X   X           X                     X
XXXXX X XXX XXXXX X X X XXX XXXXX XXXXXXX X X X XXXXXXXXX X XXXXXXXXXXX XXXXXXX X
X   X X   X X   X X   X   X X   X         X X X X       X X X X   X   X X     X X
X X XXXXX X X X X XXXXXXX X X XXXXXXXXXXX X X XXX XXXXX X X X X X X X XXX XXX X X
X X       X   X X   X   X   X     X       X X     X     X   X X X   X     X   X X
X XXX XXXXXXX XXXXX X X XXXXX XXX X XXXXXXX XXXXXXX XXXXX XXX X XXXXXXXXXXX XXX X
X   X X     X X     X X     X   X     X   X X     X X   X     X X             X X
XXX X X XXX X X XXXXXXX XXXXXXX XXXXXXX X X X XXX X XXX XXXXX X XXX XXXXXXXXX X X
X   X X X   X X X     X X         X   X X X X X   X   X       X   X X X   X     X
X XXXXX X XXX X X XXX X X XXXXXXXXX X X X X X X XXXXX XXXXXXX XXX X X X X XXXXX X
X X     X     X X   X   X       X   X   X X   X   X X X     X   X X   X X     X X
X X XXXXXXXXXXX X X XXXXXXX XXXXX XXXXXXX XXX XXX X X X XXX XXX X XXXXX XXXXX XXX
X   X       X   X X     X   X     X     X   X X   X X   X   X X X           X   X
X XXX X XXX X XXXXX XXX X XXX XXXXX XXX XXX X X XXX XXXXX XXX X XXXXXXXXXXXXXXX X
X X   X   X X X   X   X X X X         X X X X X X       X X     X       X       X
X XXX XXX X X X X XXXXX X X XXXXXXXXXXX X X XXX X XXXXX X XXX XXX XXXXX X XXXXX X
X   X X   X X   X     X   X       X X   X   X   X   X X X   X   X   X   X   X   X
XXX XXX XXX XXXXXXXXX X XXX XXXXX X X XXX XXX XXXXX X X XXX XXX X XXX X XXX XXXXX
X X   X   X     X   X X X   X     X X X   X   X     X X   X   X X X   X X X     X
X XXX X X XXX XXX X X X X XXX XXXXX X X XXXXX X XXXXX XXX XXX X XXX XXX X XXXXX X
X   X X X X   X   X X X   X   X   X X X       X   X     X   X X   X X         X X
X X X X X X XXX XXX X XXXXXXX X X X X XXXXX XXXXX XXXXX X XXX XXX X X XXXXXXXXX X
X X X X X X   X X   X   X   X   X   X     X X   X X   X   X   X     X X       X X
XXX X X X XXX X X X XXX X X XXXXXXXXXXXXX XXX X X X X XXX X XXXXXXXXXXX XXXXX X X
X   X X X   X X X X   X   X       X     X   X X X   X   X X             X   X X X
X XXX X XXX XXX X XXX XXXXXXXXXXX X X XXXXX X X XXXXX X XXXXXXXXXXXXXXXXX XXX X X
X X   X X   X   X X     X X     X   X     X X X     X X X     X     X     X   X X
X X XXX X XXX XXX XXXXX X X XXX XXXXXXX XXX X XXXXX X X X XXX X X XXX XXX X XXX X
X X   X X     X X   X     X X   X X     X   X   X   X X   X X   X       X X   X X
X XXX XXX XXXXX XXX XXXXXXX X X X X XXX X XXXXX X XXXXXXX X XXXXXXXXXXXXX XXX X X
X   X   X X       X       X X X   X X   X       X       X X       X         X   X
X XXXXX X X XXXXX XXXXXXX X X XXX X XXXXXXXXXXXXXXXXXXXXX XXXXX X X X XXXXXXXXX X
X       X   X           X   X   X X     X       X     X   X     X X X X         X
X XXXXXXXXXXX XXXXXXX XXXXXXXXX XXXXX X X XXXXX X XXX X XXX XXXXX X XXX XXXXXXXXX
X           X X     X X         X   X X X   X   X X   X X       X X X   X X     X
XXXXXXXXXXX XXX XXX X X XXXXXXX X X XXX XXX X XXX X XXX X XXXXX XXX X XXX X X XXX
X         X X   X X X X     X X X X       X X X   X   X X X   X X   X X     X   X
X XXX XXXXX X XXX X XXXXXXX X X X XXXXXXXXX X X XXXXX X XXX X X X XXX XXXXXXXXX X
X   X         X             X   X           X       X       X   X               K
XXXXXXXXXXXXXXXXXXXXXXXXXXXXXXXXXXXXXXXXXXXXXXXXXXXXXXXXXXXXXXXXXXXXXXXXXXXXXXXXX
