XXXXXXXXXXXXXXXXXXXXXXXXXXXXXXXXXXXXXXXXXXXXXXXXXXXPXXXXXXXXXXXXXXXXX
X X X     X     X X     X       X X         X     X   X   X       X X
X X X XXX XXXXX X X XXX X X XXX X XXXXXXXXX XXXXX XXX XXX XXXXXXX X X
X     X     X       X X X X X X X     X X   X     X X         X X   X
XXX X XXX X X XXXXX X XXX X X XXX XXX X X X X XXXXX XXX XXXXX X X XXX
X   X X   X X   X X   X X X X   X   X     X X X X X     X     X X   X
XXXXXXX X XXX X X XXX X XXX XXX XXXXX X XXXXX X X XXXXX XXXXX X XXX X
X   X   X     X   X X X X X     X     X X X X X   X       X       X X
XXX X XXXXXXXXXXXXX X X X XXX XXXXXXX XXX X X X XXX X X X XXX X XXX X
X       X         X   X       X                 X   X X X X X X   X X
XXX XXX XXXXX XXXXXXX X X XXXXXXX XXX X XXXXXXXXX X XXX X X X XXXXX X
X   X   X   X X   X   X X X       X   X X         X X   X X   X     X
XXX XXX XXX X XXX X XXX X XXX XXXXX X X X XXX X X XXXXXXX XXX X X XXX
X X X   X   X   X X     X   X X   X X X X   X X X     X   X X X X X X
X XXXXX XXX XXX X X X XXXXX XXX XXXXX XXXXX XXXXXXXXX XXXXX XXX X X X
X           X     X X     X       X   X   X X X X     X     X   X X X
XXX XXXXXXXXX XXX X XXXXX XXX X XXXXX XXX X X X X XXX XXX XXXXX X X X
X     X     X   X     X   X   X X   X X X X X X X X X X   X   X X X X
X XXX XXX X XXX XXXXX XXX XXX XXX X X X X XXX X XXX X X XXX X X XXX X
X X   X   X   X X   X X     X     X           X   X   X     X     X X
XXX XXX XXXXX XXX XXX XXXXXXX XXXXXXX XXX XXXXX XXXXX X XXXXXXX XXX X
X     X   X   X     X X X   X     X X X   X X   X   X X       X     X
X XXXXX XXX X XXX XXXXX XXX XXXXXXX X XXX X X XXX X X XXXXXXXXX X X X
X       X   X   X         X   X   X X   X X       X   X X X   X X X X
X XXXXXXXXXXXXXXXXXXX XXX XXX X XXX XXXXXXXXXXXXXXXXX X X X X X XXXXX
X           X X   X X X X X     X         X       X     X   X X X X X
X XXX X X X X XXX X XXX X XXX X X X XXX XXX XXX X X XXXXXXXXX X X X X
X X X X X X     X           X X   X X X X   X X X     X X       X   X
XXX XXX XXXXXXX X XXX XXX XXX XXX XXX X XXX X XXX XXXXX XXX X XXX X X
X X   X X     X   X   X   X X   X X   X X       X   X       X     X X
X XXX X X XXX XXXXXXXXX XXX XXX XXXXX XXX XXXXXXX XXXXX X XXXXXXX XXX
X         X   X X     X X   X   X X         X   X X     X       X X X
XXXXX XXX XXX X XXXXX XXX X XXX X XXX X XXXXX XXX XXX XXXXXXXXX XXX X
X   X X     X   X       X X         X X       X X   X X   X   X   X X
X X XXXXX XXX XXX XXXXX XXXXX XXX XXXXX XXXXXXX XXXXXXX XXXXX X XXX X
X X X X     X   X   X       X   X   X X X     X     X   X   X X     X
X XXX X X XXX XXXXX XXXXX XXX X XXX X X X X X X XXX X X X X X XXXXX X
X       X X X         X     X X X X X X   X X   X   X X   X         X
X XXXXX X X X XXX XXXXXXX X XXX X X X XXXXX X XXXXXXXXX X XXX XXXXXXX
X X     X X X X X X X     X X X X   X     X X X         X   X     X X
XXXXXXX X X X X XXX X XXXXX X XXX XXX X X XXX X XXXXX XXXXXXX XXX X X
X   X   X   X X   X       X X     X   X X   X   X         X X   X   X
X XXXXX X XXX X XXX XXXXXXXXXXXXX X X XXX XXX XXX XXXXXXXXX XXXXXXXXX
X       X X X   X X   X     X       X   X   X X X     X       X X   X
X XXXXX XXX X XXX XXX XXX XXX XXXXXXX X X XXX X XXX XXXXXXXXX X X XXX
X X X X X   X X             X     X X X X X   X     X   X           X
XXX X X X XXX X XXXXX XXXXXXXXXXX X XXXXX XXX X XXXXX XXXXX XXXXXXX X
X       X     X X     X         X   X X       X   X   X       X   X X
X X XXXXXXXXX X XXXXX X XXXXXXX X XXX X XXX XXXXXXX X XXX XXXXX X X X
X X   X X     X X   X   X     X     X X X           X X         X X X
X XXX X XXXXX XXX X X XXX XXXXX XXXXX XXXXXXX X XXXXXXXXXXXXXXX XXX X
X   X     X   X X X   X X     X X     X X   X X X X   X X     X X   X
X XXXXX XXX XXX XXX XXX X XXXXX X XXX X X X X X X X X X XXXXX X XXXXX
X X     X         X   X     X X   X X   X X   X X   X         X     X
X X X XXXXX XXXXX XXX X XXXXX XXX X XXXXXXXXXXX X XXX XXX XXXXXXXXX X
X X X X   X   X   X   X X       X X X   X       X X     X           X
XXXXX X XXXXX X XXXXXXX XXXXX X XXX X XXXXX XXXXXXX XXXXXXXXX X XXXXX
X     X   X   X         X     X   X       X X X X X X X       X X   X
XXX XXX XXX XXXXX XXXXX X XXXXXXXXX XXX XXXXX X X X X X XXX X XXXXX X
X   X X   X X     X     X     X     X X           X X X X X X   X X X
XXXXX X XXXXXXX X X XXX X X X X XXXXX XXX XXXXXXX X X XXX XXXXX X X X
X           X   X X X X   X X   X X     X X       X   X X X X X   X X
X X XXX X XXX X XXXXX X XXXXXXX X XXX XXXXX X XXX XXX X X X X X X X X
X X X X X   X X       X   X X X   X         X   X   X   X     X X   X
X X X XXX XXXXXXX X XXXXXXX X X X XXXXX XXX XXX XXXXXXX XXXXX XXXXXXX
X X   X X   X X   X X     X X X X X X   X     X     X     X X       X
X XXXXX XXX X XXX X X XXX X X X XXX X XXXXX XXXXX XXXXX XXX X XXX X X
X X       X X     X     X     X X X   X X X X     X X     X     X X X
X XXX XXX X XXXXXXX X XXX X XXXXX X XXX X XXX XXXXX X XXXXX XXXXX X X
X   X   X X X   X   X X X X   X   X   X X     X   X         X   X X X
XXX XXXXX XXXXX X XXX X X XXX X X X X X XXXXX X XXXXXXXXXXX X XXX X X
X                 X   X X   X   X X X X X         X       X     X X X
X XXXXXXX XXX X X X XXX X XXX XXXXX XXX XXXXXXX X XXX XXXXXXX XXX X X
X     X     X X X X X X X X X X   X           X X X           X X X X
XXXXX X XXXXXXXXXXXXX X X X X X X X XXXXXXXXXXX XXXXXXXXX XXXXX XXX X
X X   X       X   X X X X X   X X X       X X       X X   X X X X   X
X XXX XXXXXXX X XXX X X XXX XXX X XXXXX XXX XXXXXXXXX X XXX X X XXX X
X X X X X X   X X   X   X X     X   X X   X   X         X         X X
X X X X X XXX X X XXX X X X XXXXX X X XXXXX XXX XXX XXX X XXXXXXX XXX
X X       X X X X X X X X   X   X X     X X X     X X   X     X     X
X XXXXXXXXX X X X X XXX X XXXXX XXXXX XXX X XXX X X XXXXX XXX XXX XXX
X X   X       X X     X X   X     X     X   X X X X       X     X X X
X XXX XXXXX XXX X X XXX XXXXXXX XXXXX XXX X X XXX X XXX XXX X X XXX X
X           X     X     X   X       X     X       X   X X X X X     X
X XXXXXXX X XXX X XXX XXX XXXXXXX X XXXXXXXXX X X XXX XXX XXXXXXXXXXX
X       X X X   X X X X     X     X X   X   X X X   X   X       X   X
X XXX XXXXXXX XXX X XXXXX XXX XXX X X X X XXX XXXXXXXXXXX XXXXX X XXX
X X     X X   X       X X   X   X X   X     X   X   X     X X   X X X
XXXXX XXX X XXXXX X X X X XXX XXXXXXXXXXX XXX XXXXX XXXXX X XXX X X X
X   X X   X X     X X       X   X     X   X X X       X     X X     X
XXX X X XXX XXX X XXXXXXXXXXX XXXXX XXXXX X X XXXXXXX X XXXXX X XXXXX
X       X X X X X X       X     X   X     X   X               X X   X
X XXXXXXX XXX X XXXXXXXXX X XXXXXXX XXX X X X XXXXXXXXX XXXXXXX XXX X
X     X   X           X X X X   X       X X X X               X X X X
XXX XXX XXXXXXX XXXXX X X X XXX X XXXXX XXXXXXXXX XXXXXXXXXXXXX X X X
X     X X X X   X X X X   X     X X     X X       X     X   X       X
X XXXXX X X X XXX X XXX XXXXXXX XXXXXXX X XXXXXXX XXX X XXX XXXXXXXXX
X X X X   X X                     X   X   X X         X     X X X X X
X X X XXX X XXXXXXXXX XXX X X XXX X XXX XXX XXXXXXXXX XXX XXX X X X X
X X     X X   X     X   X X X X   X   X             X   X X X   X   X
X XXXXX X X XXX XXXXXXX XXX XXXXXXX XXXXX XXX XXX XXXXXXX X X XXXXX X
X X               X X   X X X         X X X     X X   X     X   X   X
X XXX XXXXXXX XXX X XXXXX XXX XXX XXXXX XXXXX XXX XXX X XXXXXXX X XXX
X X   X   X   X   X     X       X X   X     X   X X X X     X     X X
X XXX XXX XXXXX XXX X XXXXXXX X XXX X X XXXXX X XXX X X X XXX X X X X
X X X       X X   X X X       X X   X       X X X       X X   X X X X
X X XXX X XXX XXX X X X XXX XXX XXX XXXXXXX X X X X XXX X XXX X X X X
X X     X     X     X     X   X   X   X   X   X   X X   X     X X   X
X XXXXXXXXXXX XXXXXXX X XXX XXXXX X X XXX X XXX X XXXXXXX X X XXX X X
X           X     X   X X X     X   X   X   X   X       X X X X   X X
X XXX XXX X X XXXXXXXXXXX X X XXXXXXXXXXX XXX XXX XXXXX XXXXX X XXX X
X X X   X X     X   X       X X   X   X X X   X   X   X X   X X   X X
XXX X XXXXXXXXX XXX X XXXXXXXXXXX XXX X X X XXXXX X XXXXX X X XXX XXX
X   X     X X   X X     X     X X     X   X     X X X   X X X X     X
XXX X X XXX XXXXX XXX XXXXXXX X X XXX XXXXX XXXXXXX XXX XXX XXXXXXX X
X X   X X X       X X X     X       X X X     X     X X       X     X
X X X XXX XXX X XXX X XXX X XXXXXXX X X XXX X X XXXXX XXXXX X X XXXXX
X   X X     X X X         X   X     X X X X X X   X     X X X X   X X
XXX XXX X X X X XXXXXXXXX XXX X XXX XXX X X XXX XXXXX XXX X XXX XXX X
X   X   X X   X X     X   X       X   X X             X         X   X
X X X XXX X X XXX XXXXXXXXX X XXXXXXXXX X XXXXXXXXX X XXXXXXX X XXX X
X X X X X X X       X X X X X X X   X X X   X X X   X X     X X     X
X X XXX XXX XXXXXXX X X X X XXX X X X X XXXXX X XXX X X XXX X X X XXX
X X   X   X X X       X X X X   X X X   X X X       X X X   X X X X X
XXXXXXXXX X X XXXXX XXX X XXX X XXX X XXX X XXX XXXXXXX X X XXX XXX X
X X       X X     X   X X   X X         X X   X X       X X   X   X X
X X XXX X X X XXXXX XXX XXX XXX XXXXX X X X XXX XXX XXXXX X XXXXX X X
X X   X X     X X X X X   X X   X   X X X     X X   X     X   X     X
X X XXXXX XXXXX X X X X XXX XXXXXXX X XXXXXXX XXXXX XXXXXXX X XXX X X
X X   X     X   X   X X     X X     X           X X X     X X     X X
X X XXXXX XXX XXX X X XXXXX X X XXXXX X XXX XXX X XXX X X XXX XXXXXXX
X     X X       X X   X     X       X X   X   X X     X X   X   X X X
X X X X XXX XXX X XXXXXXX X X XXX XXX XXXXXXX X X XXXXX XXXXX XXX X X
X X X   X X X   X     X   X X X       X     X X   X X   X           X
XXXXXXXXX XXX X XXXXXXX X XXX XXX X XXX XXX X XXXXX XXX XXX XXX X XXX
X     X     X X       X X     X   X X   X   X         X     X   X X X
XXXXX XXX XXX XXXXX XXX X XXXXXXX XXX X XXX XXXXXXXXXXX XXXXX X XXX X
X   X X X         X X   X X   X   X   X   X X       X X X X   X X   X
XXX X X XXX X XXXXX X XXX X XXXXX XXX X XXXXXXXXXXX X X X XXXXXXX XXX
X X         X X   X   X X     X X   X X     X     X       X X       X
X XXX XXX XXXXX X X XXX X XXXXX XXX XXX XXX XXXXX XXXXX X X XXX X X X
X     X         X X X     X X X     X   X   X       X X X X     X X X
X XXXXXXXXXXXXXXXXXXX X X X X X X XXXXX X X XXXXXXX X X XXX XXX XXX X
X X     X   X   X   X X X X   X X     X X X   X X X X     X   X   X X
XXX XXX X XXX XXX XXXXX XXX XXXXX XXX X XXXXXXX X X XXXXX X XXX XXX X
X   X X   X   X   X   X       X     X       X         X     X     X X
XXX X XXX XXX XXX XXX XXXXX XXXXX XXXXX XXXXXXX XXX XXXXX XXX X XXXXX
X X   X                     X   X X X X X X X     X X   X X   X     X
X XXX X X X XXX XXXXXXX XXXXX X X X X X X X XXX X X XXX XXXXXXX X XXX
X     X X X X X X   X   X     X   X   X       X X X       X     X   X
X X X X X XXX XXXXX X XXXXXXX X X X X XXXXXXXXXXXXX X XXX X X XXX XXX
X X X X X   X     X X   X   X X X   X   X   X       X X     X X     X
XXX XXXXX XXXXXXX X XXXXX XXX XXXXXXXXX XXX XXXXX X XXX XXXXXXXXXXX X
X       X       X X     X   X   X             X   X X X   X   X   X X
XXX XXXXX XXXXXXX XXX XXXXX X X XXXXX XXXXX X XXXXXXX XXX X XXX XXX X
X       X X X       X       X X   X X     X X   X   X       X X X   X
X XXXXXXXXX X XXXXXXX XXXXX XXXXX X XXX XXXXX XXX XXXXX X XXX X X XXX
X   X   X       X     X   X     X X       X X   X   X   X   X       X
X X XXX XXX XXX X X XXX X X X XXXXXXXXX X X XXXXX X X XXX XXXXXXXXX X
X X     X   X     X   X X   X X X   X X X         X X   X   X     X X
XXX X XXXXXXX XXX XXX XXX XXXXX X XXX XXXXXXXXXXXXX XXXXX XXXXXXX XXX
X   X     X     X   X   X X X     X X       X X   X   X     X   X   X
X XXXXXXXXX XXXXXXXXX X X X X XXXXX XXXXXXX X X XXXXX XXXXXXX X X XXX
X X           X X     X X X     X X   X X             X     X X X   X
X X XXXXX XXX X X XXX XXX X X X X X XXX XXX X XXXXXXX X XXX XXX XXX X
X     X   X X X X X   X X   X X   X     X X X X       X   X     X   X
XXX XXXXXXX XXX XXX XXX XXXXXXX XXX XXXXX X XXX XXXXXXXXX X XXX X X X
X X     X       X     X       X X X X       X   X X       X   X   X X
X X XXXXX XXXXX X XXX XXXXX XXXXX X X X XXXXXXX X XXX XXXXXXX XXX X X
X   X       X   X   X X   X       X   X     X X   X   X     X X X X X
X XXXXX XXX XXXXXXXXX XXX XXXXX XXXXXXXXXXXXX X XXX X X XXX X X XXX X
X   X X X   X       X X         X X           X X X X X X   X X   X X
XXX X X X X XXX X X X XXX XXX X X XXX XXX X XXX X X XXXXX X XXXXX XXX
X X     X X     X X X X   X   X X     X   X   X         X X   X     X
X X XXXXXXXXXXXXXXX X X X XXX XXXXXXX X X XXXXXXXXXXXXX XXXXX X X XXX
X   X X     X   X   X   X   X X     X X X   X   X               X X X
X X X XXX X XXX XXXXX X XXXXXXXXX XXXXX XXXXX XXXXX XXXXXXX XXXXX X X
X X X X   X       X X X   X   X   X         X     X   X X   X   X X X
X XXX XXX X X XXX X X XXX X XXXXX XXX XXXXX XXXXX XXXXX XXX X XXXXX X
X X X X   X X X         X   X           X     X X       X   X X X   X
X X X X XXXXX XXXXX X X XXXXXXXXX XXX X XXXXX X XXXXXXX XXX X X X X X
X   X       X X     X X   X         X X     X                     X X
XXXXXXXXXXXXXXXXXXXXXXXXXKXXXXXXXXXXXXXXXXXXXXXXXXXXXXXXXXXXXXXXXXXXX
