XXXXXXXXXXXXXXXXXXXXXXXXXXXXXXXXXXXXXXXXXXXXXXXXXXXXXXXXXXXXXXXXXXXXXXXXXXXXXXXXXXXXXXXXXXXXXXXXXPXXXXXXXXX
X   X     X   X   X         X         X X         X   X           X X       X   X       X   X             X
XXX XXX XXXXX X XXX XXXXXXXXX XXXXXXX X X X XXXXX X XXX XXX XXXXXXX XXX X XXX X XXX X X X XXXXXXX X XXX XXX
X X   X X   X X       X X X X   X     X X X   X X   X   X   X X X   X X X   X X   X X X X   X   X X X     X
X X XXX X X X XXXXXXX X X X X XXXXXXX X XXX XXX X XXXXXXX XXX X X X X XXX XXX XXXXXXX XXXXX X X X XXXXXXX X
X         X       X       X   X   X X   X     X   X         X     X   X   X X X     X     X   X       X X X
X XXXXXXX X XXX XXX XXX X XXX X XXX XXX X X X X XXXXXXX X X X X XXXXXXX X X X XXX X XXX X XXXXX XXXXX X XXX
X X     X X X       X   X X   X X X X X   X X X X       X X X X       X X X       X X   X         X X     X
XXX XXXXX XXXXX XXX XXXXX XXX X X X X XXXXXXXXXXX XXX X X XXX XXXXXXX X X X X X XXX XXX X X XXXXX X XXX XXX
X X       X     X       X X   X X   X X X X   X   X   X X   X   X       X   X X X X   X X X   X     X     X
X X X XXX XXXXXXX X XXXXX X XXX X X X X X X XXX XXXXXXX XXX X X XXX XXX X XXX X X X X X XXX X XXX XXXXXXXXX
X   X X     X     X X       X     X X       X X X   X   X     X X X X   X   X X   X X   X   X   X   X     X
XXX XXXXXXX XXXXX XXXXXXX XXX XXXXX X X XXXXX X X XXXXXXXXXXXXXXX XXX XXXXX XXXXX XXXXXXXXXXXXX XXXXX X XXX
X X   X       X       X X X   X X X   X   X X   X       X     X           X X       X X   X X X     X X   X
X X X XXX X X XXX X X X X X X X X XXXXXXX X XXX X X X XXX XXXXX XXX XXXXXXXXXXXXX XXX X XXX X XXXXX XXXXX X
X X X X X X X   X X X   X   X X   X X   X X     X X X   X     X   X   X       X X   X       X   X   X     X
X X XXX X XXXXXXXXX XXX X XXX XXX X XXX X X X XXX X XXX XXXXX X XXX XXX XXX X X XXX X XXX XXXXX X X X X XXX
X     X     X X X     X X X           X   X X     X   X   X     X   X   X   X     X   X     X X   X   X X X
X X XXXXX XXX X XXXXXXX X X XXXXXXX XXX XXXXXXXXX X X XXXXX XXXXXXX X X XXX XXXXXXXXXXXXXXX X X XXX XXXXX X
X X X   X X   X   X   X X X X X   X   X   X   X X X X   X X   X X   X X X     X         X   X   X   X     X
X XXX XXXXXXX X XXX XXX XXX X X XXXXXXX XXX XXX XXX XXX X X XXX X XXX X XXXXX XXX XXX XXXXXXXXXXXXX XXX XXX
X X     X     X     X     X     X X     X   X     X X X X   X   X     X   X X   X   X   X X X   X   X     X
X X XXX X XXX X XXXXX X XXXXX X X XXXXX X X XXX X XXX X X XXXXX XXX XXXXX X XXXXXXXXX X X X XXX XXXXX XXX X
X     X   X   X X     X X X   X X         X X   X       X X X       X       X X   X   X X       X   X X   X
X X X XXX XXXXX XXX XXXXX XXX XXXXX XXXXXXX XXX X X X XXX X XXXXXXX XXX XXX X XXX X XXX XXXXXXX XXX X X XXX
X X X X     X         X   X     X   X X   X   X X X X X     X   X X X X   X   X   X   X               X   X
X XXX XXX XXX XXX X X XXX XXX X X XXX XXX XXX X X XXX XXXXXXX X X X X X XXX XXX X XXXXX X XXX XXXXX X XXX X
X   X X   X   X X X X X   X   X X           X   X X X X     X X     X X   X     X       X X     X   X X X X
X XXXXX XXX XXX X X X X XXXXX X X XXXXXXX X XXX X X X XXX X XXX XXX X X XXX X XXX X XXXXXXXXXXX X X XXX X X
X   X     X     X X X X       X X   X     X   X X   X     X X   X   X   X   X X   X       X     X X X     X
XKXXXXXXXXXXXXXXXXXXXXXXXXXXXXXXXXXXXXXXXXXXXXXXXXXXXXXXXXXXXXXXXXXXXXXXXXXXXXXXXXXXXXXXXXXXXXXXXXXXXXXXXXX
