XXXXXXXXXXXXXXXXXXXXXXXXXXXXXXXXXXXXXPXXX
X       X     X         X X X         X X
XXX XXXXXXXXX X XXX X XXX X XXX X XXXXX X
X X X X   X       X X X     X   X     X X
X X X X XXX XXXXXXXXXXXXX XXX X XXX X X X
X X   X   X X               X X   X X X X
X XXX XXX X XXX X XXXXX XXXXXXXXX XXXXX X
X   X     X   X X X   X     X   X X     X
X XXXXX XXXXX X X X XXXXX XXXXX X XXXXX X
X               X       X           X X X
XXX XXXXXXX XXXXX XXX X X X XXX X XXX X X
X   X X     X     X X X X X X   X   X X X
X XXX X XXX X XXX X X XXXXXXX X XXXXX X X
X X   X X   X X     X X       X X   X   X
XXXXX XXX XXXXXXXXX X X X XXXXX X X X XXX
X     X   X X X X   X X X X   X   X   X X
XXX XXX XXX X X XXX X X X X XXXXX XXX X X
X X       X X   X   X X X     X   X X   X
X XXXXX XXX X XXXXXXXXXXX XXX XXX X X X X
X       X   X       X     X X X   X   X X
X XXXXX X XXX X X XXXXX XXX XXX XXX XXXXX
X X X     X   X X X   X X X X   X       X
XXX XXX X XXX XXXXXXX X X X XXX X X X XXX
X   X   X X     X             X X X X   X
X XXXXX XXXXX XXXXXXXXXXXXX X XXX XXXXXXX
X   X   X                   X X         X
X XXXXXXXXX X XXXXX XXXXX X XXXXX X XXXXX
X   X X X X X X   X   X X X   X   X     X
X XXX X X X XXXXX XXXXX XXXXX X X XXX XXX
X X     X   X X           X   X X   X   X
X X XXX XXX X XXXXX XXXXX X XXXXX XXXXXXX
X X   X     X X X X     X X X   X X X   X
X XXX XXXXXXX X X X XXXXXXXXX XXX X X XXX
X   X     X X X                 X     X X
XXX XXX XXX X X XXX X XXX X X XXXXXXX X X
X       X X   X X   X X X X X X X   X   X
X X X X X X X XXXXX XXX XXXXX X X XXXXX X
X X X X     X             X   X X       X
X XXX XXX XXXXX X X X X X X XXX X XXX XXX
X X     X     X X X X X X X     X X     X
XXXXXXXXXXXXXXXXXXXXXXXKXXXXXXXXXXXXXXXXX
