XXXXXXXXXXXXXXXXXXXXXXXXXXXXXXXXXXXXXXXXXXXXXXXXXXXXXXXXXXXXXXXXXXXXXXXXXXXXXXXXXXXXXXXXXXXXXXXXXXXXXXXXXXXXXXXXXXXXXPXXXXXXXXXXXXXXXXXXXXXXXXXXXXXXXXXXXXXXXXXXXXXXXXXXXXXXXXXXXXXXXXXXXXXXX
X           X       X X X   X   X     X   X X     X     X X         X       X     X X         X X   X X     X X       X X X X   X       X   X X       X   X X X X       X   X     X X       X
XXXXX XXXXX X XXXXX X X XXX XXX XXX X X XXX XXXXX XXX X X XXXXX XXX X XXX XXX XXXXX XXXXXXX XXX X XXX XXXXX X X XXXXX X X X X XXX X X XXXXX X X X X XXX XXX X X X XXX XXXXX X XXXXX X X XXX X
X X   X       X X X   X X           X         X   X   X   X X   X   X X   X X X         X   X   X   X   X     X   X X   X X     X X X X   X X   X X   X   X     X X   X X X         X X   X X
X X XXXXXXXXX X X XXXXX XXXXX X XXXXXXXXX XXXXXXX XXXXX X X X XXXXX XXX XXX X X XXX X XXXXX X X XXX XXX X XXXXX XXX XXX X X XXXXX XXX X XXX XXXXX XXX X X X X XXXXXXX X X XXX X X XXXXX XXX X
X     X X   X     X X   X X   X         X X X X     X   X X     X     X X   X   X X X X X     X X         X X X X X     X X   X   X       X   X X   X   X X X             X X X X X     X   X
X XXXXX XXX XXXXXXX XXX X XXX XXXXXXXXXXX X X X XXX X XXX X X XXXXXXXXX XXX X XXX X XXX XXX XXX XXXXXXXXX X X XXX X X XXX X XXX XXXXX X X X XXX XXXXXXX XXX XXX X X XXXXX X X XXXXXXX X XXXXX
X   X         X         X   X           X     X X X X   X X X       X         X X X   X       X   X             X   X X   X X     X X X X   X X         X X   X X X   X X   X X X X   X     X
X XXXXX XXX X XXX X XXX XXX X XXXXX XXX X X XXX X X X XXX XXXXX XXX XXXXXXXXXXX X XXX XXX X XXX XXX XXX XXX X X XXXXX X X X XXX XXX X X XXX X XXX X XXX X XXXXX X XXX X XXX X X X X XXXXX XXX
X X X   X   X     X X     X   X   X X   X X X     X X   X     X   X X X     X             X X X X   X     X X X X X X   X X X X X X X X X   X   X X   X         X X X   X       X X   X     X
X X XXX XXXXXXXXX XXX XXXXXXX X XXXXX XXXXX X X XXXXXXX X XXXXX XXX X X X X X XXXXXXXXX XXX X X X XXX X XXXXX XXX X X XXXXX X XXX X XXX XXXXXXX X XXXXXXX XXX X XXX XXX XXXXX XXX XXXXXXXXX X
X   X     X   X     X     X   X   X     X     X   X X   X     X   X X   X X X X X X X   X X X X   X X X X     X X X     X X X X   X   X X     X X X     X X   X X X X X X           X   X   X
XXX X XXXXXXX X XXXXXXXXXXXXXXX X XXXXXXXXXXXXX XXX X XXXXX XXXXXXX XXXXX XXX X X X XXX X XXX XXXXX X XXXXXXXXX X X XXX X X X X X XXX X XXXXX X XXX X XXX X X XXX X X X XXXXX XXXXX X XXX XXX
X     X X X   X X       X X X   X             X   X X     X X   X X   X X       X       X     X X         X X     X X X       X X X     X           X X   X X         X X X X X   X X     X X
XXX XXX X X X XXX X XXX X X X XXXXXXXXXXX XXXXXXX X X XXX X X XXX XXX X X XXXXXXX XXX XXXXX X X X X XXXXXXX X X XXXXX XXX X X XXX XXX XXXXX X X X X XXXXX XXX XXX XXXXXXX X X X XXX X X XXX X
X     X   X X   X X X         X   X   X   X X   X     X X X X X X     X   X     X   X     X X     X   X X X   X           X X X     X       X X X X X       X X X       X   X   X X X X     X
X XXXXXXX XXXXX XXX X XXXXXXXXXXX XXX X X X X X XXXXX X XXXXX X XXX X X X X XXX XXXXX X XXXXXXXXXXX XXX X XXXXXXXXXXX X XXXXXXXXX XXXXX XXXXX XXX XXXXXXXXXXX X XXXXX XXX XXX XXX X X X XXXXX
X X   X     X X     X X       X   X     X X X X   X X X   X X   X   X X X X X X       X         X   X     X X         X X   X       X X X   X X               X   X       X X X   X   X X X X
X X XXXXX X X XXX XXX X XXXXX XXX XXXXX XXX X X XXX X X X X X XXXXX XXXXXXXXX XXXXX X XXXXXXXXXXXXX X XXXXX XXXXXXXXXXX X XXX XXXXX X XXXXX XXX XXX XXXXXXX XXXXX XXXXXXXXX X X X XXXXX X X X
X     X   X X     X X   X   X X   X   X   X   X X   X X X X   X           X   X X X X         X   X X   X     X   X   X         X X X X       X   X     X       X     X   X     X   X       X
XXX XXXXXXX X XXXXX XXX X XXXXX X X XXXXXXX X XXX X X X XXX X XXXXXXX X XXX X X X XXX X XXXXXXX X X X X X XXXXX X XXX XXXXX XXX X XXX XXX X X XXXXXXXXX XXX X XXXXX XXXXX XXX XXXXX X X XXX X
X   X               X     X X X X   X       X X   X       X X X       X   X X       X X X       X X X X       X X X           X   X X   X X X X X   X   X X X   X     X   X     X X X X   X X
X X XXXXXXX XXX XXXXX XXXXX X X XXXXX XXXXXXX XXX XXXXX X X X X XXXXXXX XXX X X XXX X X X X X XXX XXX X X XXX X X X X XXXXX XXXXX X X X X X XXX X X X XXX XXXXXXXXX X X XXXXXXXXX XXXXXXXXX X
X X           X X         X     X X     X   X   X   X   X   X   X     X   X X X X X   X   X X   X   X X X   X   X   X X   X   X     X X X X     X X   X       X     X   X           X X   X X
XXXXXXX XXXXXXXXXXX X XXXXXXX X X X XXX X XXXXX X XXXXXXX XXXXXXXXXXX XXX X X X X X XXXXXXX XXXXXXX X XXXXX XXXXXXX XXXXX X XXXXXXX X XXX XXX XXX X X XXXXX X X XXXXXXXXXXXXX XXXXX X XXX X X
X   X     X X X   X X     X   X       X   X X         X     X   X X X       X X X         X X     X   X       X     X X   X   X   X X     X       X X       X X   X     X   X   X X     X X X
X XXXXX XXX X X XXX XXXXX XXX XXX XXXXXXXXX XXX X XXX XXX XXX XXX X XXXXXXXXX XXX XXX X XXX X XXXXX XXXXXXXXXXX X X X X XXX XXXXX X XXXXXXX XXXXXXXXXXXXX X X X XXXXXXX X XXX XXX XXX X X XXX
X       X   X   X     X   X   X   X X         X X X     X   X   X X       X X   X X   X X     X         X   X   X X X       X     X X   X       X     X X X X   X     X       X   X   X     X
XXXXXXXXXXX XXX X X X X X X XXXXX X XXXXXXX XXX XXXXX X X XXX XXX XXX X XXX X XXX XXXXXXX X XXXXXXXXX XXXXX XXXXXXXXXXX XXXXXXX X X X X XXX XXX X X XXX X X X XXX XXXXX X XXX XXX XXX X XXXXX
X X X X           X X X X     X     X   X X X X X     X X         X X X X       X X     X X X   X X X         X X         X   X X   X X X X   X X X       X X X         X X       X   X     X
X X X X XXXXX XXXXX XXX X X X XXX XXX X X X X XXXXX X X X XXXXXXXXX X XXXXXXXXX XXX X X XXXXXXX X X X X X XXX X XXX XXXXX X XXX X XXX X X XXX XXX X XXXXX XXX XXXXXXXXX XXXXXXXXXXX X XXXXX X
X           X X   X X X X X X X   X X X X X       X X X X       X   X   X X   X     X X     X     X   X X X X X   X   X   X     X     X   X   X   X     X X   X       X   X         X X   X X
X XXXXXXX X XXX X XXX XXXXXXXXXXX X XXX X XXXXX X XXX XXXXX XXXXXXX XXX X X X X XXXXXXX XXX X X X XXX XXX X XXX X X XXX XXXXXXXXXXXXXXXXX XXXXX X X X XXXXXXXXX XXXXXXX XXXXX XXX X X XXX X X
X   X   X X X X X     X   X     X   X   X     X X     X     X   X X         X   X X X   X   X X X   X X   X X   X X X       X X     X   X     X X X X   X   X X X       X       X X X   X   X
X X XXX XXXXX XXXXXXX X XXX XXX X XXX XXX XXXXX XXXXX X XXX XXX X XXX X XXX XXXXX X X X XXX X XXXXX X X XXX X XXX XXXXXXXXX X X X X X XXXXX XXXXXXXXX X X XXX X XXX X XXX X X X XXX X XXXXX X
X X     X X X         X X X   X X X           X   X X X X     X X   X X X           X X X   X   X     X   X   X X X         X   X X X X X X X X   X   X X X X X   X X   X X X X X   X   X X X
X XXXXX X X XXXXXXX X X X XXX XXX XXX XXX X XXXXXXX X X XXXXXXX X XXXXXXX XXXXXXXXXXX XXX X XXX XXXXXXXXX X X X X XXX XXXXXXX XXX X X X X X X X X XXXXX X X X XXX XXX X XXX XXXXXXXXX XXX X X
X   X   X   X X   X X X           X X   X X   X X X X X X X X               X       X   X X X X   X         X   X X     X       X X X           X         X           X   X         X     X X
XXX X XXXXX X X XXX X X XXXXXXXXXXX XXX XXX XXX X X XXX X X XXXXX XXXXX XXXXXXXXX X XXXXX XXX XXX XXX XXXXXXX XXX X XXX X XXX X XXX X X X XXX X XXXXXXXXX XXX X XXXXXXXXXXX XXX X XXXXXXX XXX
X X X X     X X     X X X     X     X     X   X   X   X     X X     X   X   X     X         X X   X   X   X X X   X X   X   X X X X X X X X X X   X   X     X X           X X   X X   X X   X
X X XXXXXXX X XXXXX X X XXX XXXXX X XXXXXXX XXX XXX XXXXX XXX XXXXX XXXXX XXXXXXXXXXX XXXXX X X XXXXX XXX X X XXX XXX XXXXXXX XXX X X XXXXX X XXXXX XXX XXX XXXXXXXXXXXXXXXXX X XXX X X X X X
X X   X X   X   X   X   X         X     X       X   X   X   X               X   X     X   X X   X X X     X   X X   X X   X X X   X     X       X   X   X   X   X     X     X X X X X   X X X
X XXXXX XXX XXX XXXXXXX XXX X X XXXXXXXXXXXXX XXX X XXX X XXXXXXXXXXXXXXXXX X XXX XXXXX XXXXX XXX X X XXXXXXX X XXXXX X XXX XXXXX X XXX X XXX X XXX X X XXXXXXX XXX XXXXXXX X X X XXXXX XXX X
X         X X       X       X X           X       X   X     X       X   X   X   X       X X   X X     X X         X         X   X X X   X   X X     X X       X         X X   X X     X X   X
X XXXXX X X XXX XXXXX X XXXXXXX X X XXXXXXX XXXXX XXX XXX XXX XXXXX X XXXXX XXX XXX XXXXX X X X XXX XXX XXXXXXX XXXXX XXX X XXX X XXXXXXXXXXXXXXX X XXXXXXX X XXXXXXX XXX XXX X XXXXX X XXX X
X X     X       X   X X       X X X   X     X X   X   X   X X X   X X       X   X X   X X   X X         X X X X X     X   X   X         X       X X   X     X   X   X   X X X X   X X   X   X
X XXXXX XXXXX X X X XXX XXXXX XXXXX XXXXXXX X X XXXXX XXX X X X X X XXX XXX X XXX XXXXX XXX X XXXXXXXXXXX X X X X XXXXX X XXX X XXXXXXXXX XXXXXXXXX XXX XXXXXXX X X X XXX X XXXXX X X X X X X
X X X   X   X X X X       X X   X X X     X   X   X X   X X X X X         X         X       X     X   X       X X   X   X   X       X           X     X X   X     X   X     X         X X X X
X X X XXXXX X X XXXXXXXXXXX XXX X XXXXX XXX X XXX X X XXXXX XXX XXX X XXX XXXXX XXXXXXX XXXXX XXXXXXX X XXXXX XXX X XXXXXXX XXX X XXXXXXXXX X XXXXX X X X XXXXXXX XXXXXXX X XXX XXX XXXXXXXXX
X   X     X X X   X   X   X X X     X   X   X   X X X   X X X   X X X X       X   X     X       X X X   X X X   X X X X     X   X   X   X X X       X X X X X   X         X   X X       X X X
X XXX X XXX XXXXXXX X X XXX X XXX XXX XXX XXXXXXX X XXX X X X X X XXXXX XXXXXXXXXXX XXX XXXXX X X X XXXXX X X X XXX X XXXXXXX X XXXXX XXX X XXX XXXXX XXX X X X XXX XXX XXX XXX XXXXXXXXX X X
X X X X     X     X X X   X X     X X           X   X     X   X X X         X   X X X X X   X X     X X   X   X X   X       X X X         X X X X X X     X X X X X   X X     X X X         X
XXX XXXXX X XXXXX XXX XXX X XXXXX X X XXXXX XXXXX X X XXXXX XXXXX X XXXXXXXXX XXX XXX X XXX X X XXXXX XXX XXXXX XXXXX XXXXX XXX X X XXXXXXXXX XXX X XXX XXX X XXX XXXXX XXX X X X XXXXXXX X X
X X X   X X     X   X     X     X X   X     X     X X X X       X X X X     X   X X   X     X X   X X     X   X X     X     X   X X   X X   X       X   X     X       X X X X X X         X X
X X X XXX XXX X X X X XXXXXXX XXX X X XXX XXXXX X X XXX XXXXX XXX XXX X X XXXXX X X X XXX XXXXXXX X XXX XXX XXX X X X X XXXXX XXX X XXX X XXX X XXXXXXX X X X X XXX X XXX XXX X X XXXXXXXXX X
X     X   X X X X X   X       X   X X X X X   X X X   X   X   X   X   X X   X   X   X X X   X X X   X   X X   X   X X X X         X   X     X X   X X     X X   X X X X       X     X     X X
X XXX X XXX X XXX X XXX X XXX X XXX X X XXXXX X XXX X XXX X X X X X X XXXXX X XXX XXX X XXX X X XXX X X X XXX XXXXXXX XXXXX X XXX X X XXXXX XXXXX X X XXX XXXXXXX XXXXX X XXXXXXX XXXXXXX X X
X   X X X       X X     X X   X     X     X X X   X X X     X X X   X X X     X X X     X         X   X X X       X X       X   X X X     X   X     X X X   X         X X X X     X   X   X X
XXX X X XXXXXXX X XXXXX X X XXXXX XXXXX XXX X XXXXX XXX X XXXXX X XXX X XXXXX X XXX X X XXXXX X XXX X XXX X X XXXXX X X X XXXXXXXXX XXX XXXXX XXX X X X XXX X XXXXXXXXX XXX X X XXX XXX XXX X
X X X X   X   X       X X X X       X     X     X X X X X     X X X X X   X X X X   X X     X X X   X   X   X X X     X X X     X   X X X X   X   X X   X   X   X     X   X   X X   X       X
X X X X XXX X XXXXXXX X XXX X XXXXXXXXX X XXXXX X X X XXXXX XXX XXX XXXXX X X X X X X XXXXX XXXXXXX XXXXXXXXX X X XXX XXX X X XXXXXXX X X X X XXXXX XXXXXXXXXXX X XXXXX XXX XXXXXXX XXX XXX X
X X X   X X X X   X   X   X X       X X X X   X X   X     X   X X X       X       X X X   X     X X   X       X X X     X   X X X   X       X       X X   X X   X         X X           X X X
X XXXXX X XXX XXX X XXX X XXXXXXXXX X XXX XXX X X XXXXX XXXXXXX X X XXXXX XXXXXXXXXXX X XXXXX XXX XXXXXXX X X X XXXXXXX XXX XXX X XXXXXXXXX XXX XXX X XXX X X X XXX XXX XXX X XXXXXXXXX X XXX
X   X       X     X X   X     X     X X     X   X X   X X   X X X     X         X     X   X X X       X   X X X       X X   X X   X X X X   X X   X X X   X   X       X     X   X   X     X X
X XXX XXXXX X XXXXXXXXXXXXX X XXXXXXX X XXXXXXX XXXXX X X X X X X XXX XXX XXXXX XXX XXXXX X X X XXXXXXXXX X X X XXXXXXX X XXX X X X X X X XXX XXX XXX XXX XXX XXX X X XXXXX XXX X X X X XXX X
X   X   X X   X         X X X   X   X     X     X X X   X X X     X     X   X     X   X       X X     X X X X         X X   X   X               X X X     X X   X X X     X X   X X X X X   X
X XXXXXXX XXX XXXXX XXXXX XXXXXXXXX X XXXXXXXXX X X XXX X XXX XXXXXXX XXXXXXXXX X XXXXX XXX X X X XXXXX XXXXX XXXXX X XXXXXXXXX XXXXXXX XXXXXXXXXXX X XXX X XXXXXXXXXXXXX X XXXXXXX XXXXX XXX
X           X     X     X   X     X     X     X   X     X         X   X     X   X X       X X   X   X X     X X     X             X   X     X       X X           X     X X X X             X
X XXX XXX X XXX XXXXX XXX XXXXXXX X XXX X X X X X XXXXX X XXX XXX X XXX X X XXXXXXXXXXXXXXX X XXX XXX X XXX X X XXX XXX X XXXXXXX X X X XXXXX XXXXXXX XXX XXX XXX XXX XXXXX X XXXXXXXXX X X X
X X     X X X         X               X   X X   X X X     X     X X   X X X   X   X   X   X X     X X   X   X X X   X   X X       X X X X       X       X X   X X X     X       X       X X X
X X XXXXXXX XXX X XXX X XXX XXXXX XXX X XXXXX X XXX X XXXXXXX XXXXX X X XXXXXXX XXX XXXXX X X XXXXX X X XXXXX XXXXXXX XXXXXXX XXX XXX X X X XXX XXXXXXXXX X X X XXXXX XXXXX XXXXXXX XXXXXXX X
X X   X X   X X X X   X X   X   X   X X   X X X   X     X       X X X X X X   X X X X X     X         X       X X   X X   X   X X   X   X X X       X X X X X X             X         X     X
X X XXX X XXX X X XXXXX XXXXXXX X XXXXX XXX X XXX X XXXXXXXXX XXX XXXXX X X XXX X X X X X XXXXX X XXXXXXX XXX X XXX XXX XXX XXX XXX X XXX X XXXXX XXX X X XXXXXXX XXX XXX X X XXXXX XXXXXXX X
X X X       X   X X       X X       X   X X     X     X   X   X X       X           X   X   X   X   X     X     X     X       X   X X     X   X   X   X X       X X     X X X   X X X X     X
X XXX XXX X X XXX X X XXX X XXX X XXX X X XXXXXXX XXX X XXX X X X X XXX XXX XXXXXXX X X XXXXXXX XXXXXXX X XXX XXX XXX XXX XXXXX X X XXXXXXX X XXX XXX X X XXX XXXXXXXXX XXX XXX X XXX XXXXX X
X   X X   X   X   X X   X X     X X X X X X X X X X     X   X X   X X X   X     X   X X X   X     X X X X X X   X X     X X X   X   X     X X   X X X   X   X X       X X         X X       X
XXX XXX X XXXXX XXX X XXXXXXXXX XXX XXX X X X X XXX X XXX XXXXX X X X X XXX XXXXXXXXXXXXX XXXXX XXX X XXX X X X XXX XXX XXX XXXXX XXXXXXX X X X XXX XXX XXX XXXXXXX XXX XXX X XXX X XXX X XXX
X X   X X   X X X   X X X       X   X   X       X   X X X     X X X X   X   X         X     X X X         X   X     X X     X   X X   X   X X X X X     X X     X         X X X X X   X X X X
X XXXXXXXXXXX X X X XXX XXXXXXXXX XXXXX XXX XXX XXXXXXX XXX X XXXXX XXX XXX X X XXXXXXXXX X X XXX XXXXXXXXXXXXX X XXX X XXX X X XXXXX XXX XXX X X X X XXX X X XXXXXXX XXXXX XXX XXX XXX XXX X
X X         X X   X     X           X   X   X         X X   X         X   X   X X   X X X X X X   X X     X   X X X X   X   X X X X X         X     X       X     X   X           X X     X X
X X XXX XXXXX X XXXXXXX X X XXXXX X X XXX XXX X X XXX X XXX XXX XXXXX XXXXX XXXXX XXX X X X X XXXXX XXX XXX X XXX X XXX XXX X X X X XXXXXXXXX X X X XXXXX XXX XXX X XXXXXXXXXXX XXX X XXXXX X
X   X X X       X     X X X X   X X X   X X   X X X     X X X   X   X X X     X           X X X     X X     X   X X     X   X X     X   X     X X X X   X X X X   X   X     X     X X X     X
X XXX XXXXXXX XXX XXX XXX XXXXX XXX XXX XXX XXX XXXXXXX X X X XXXXX X X XXX XXX XXXXXXX XXX X XXX X X X XXX X X X XXXXXXX XXX X XXXXX X XXXXX XXX XXXXX XXX XXX X XXXXXXXXX XXXXXXX XXX XXX X
X   X X     X X     X       X X X           X   X X     X X X   X     X X     X X X   X X   X     X X   X   X X X X           X X   X X X X   X X   X     X   X X X     X       X   X X X   X
XXX X XXX X XXXXX X XXXXX X X X X X X XXX XXXXXXX XXX XXX X XXX XXX XXX X XXX X X XXX X X X X XXX X X XXXXXXXXX XXXXXXXXX X X XXXXX X X X XXXXX XXX X XXX XXX XXX X XXX X XXX XXXXX X X XXX X
X X   X   X X     X   X X X   X   X X X X X X X   X X X   X   X   X X       X X X   X   X X     X X X X   X X X X X       X X X X   X X X X     X X X X   X X X       X   X   X X   X   X   X
X X XXX X X X XXXXX XXX XXXXX XXXXX XXX X X X XXX X XXXXX X XXX XXX XXX XXXXXXXXX XXXXXXX XXXXXXX X X X XXX X X X X XXX XXXXXXX X X XXX X X XXX X XXX XXX X X XXXXXXXXXXX XXX X XXX XXX XXX X
X   X X X X   X X   X   X   X X   X X       X X   X   X X X   X X X X X           X   X X X   X   X X X       X   X X   X X X X   X X X X     X   X   X X             X   X X X X       X X X
X X X XXX XXXXX X XXX XXXXX XXXXX X X XXXXX X X X X XXX X X XXXXX XXX XXXXX XXXXX X X X X X X X X XXXXX XXX X X X XXXXXXX X X X XXXXX X X XXXXX XXXXXXX X X XXXXX XXX XXXXX XXX XXXXXXXXX X X
X X         X   X X X               X X   X X   X   X X   X X       X   X       X   X   X   X X X       X   X   X X   X     X     X X X X   X   X     X   X X       X X X   X   X       X   X
XXXXXXX X X X XXXXX XXX X XXXXX X X XXX X X X XXX XXX X XXX XXX X X XXX XXX X XXX XXXXX X X XXX XXXXXXXXX XXX XXX XXX X XXX XXX XXX X X XXX XXXXX X X XXXXXXXXX X XXX X XXX XXX XXXXX X X X X
X   X X X X     X   X   X     X X X X   X X X X X X X X   X X   X X   X     X X   X X     X   X   X X   X X   X X     X X   X X       X X   X X   X X           X   X       X   X     X   X X
X XXX X XXXXX XXXXX XXX XXXXXXX XXX X X X XXX X XXX X XXX XXX X X XXX XXXXX XXX XXX XXX XXXXX XXXXX XXX XXXXX X XXX X XXXXX X X XXXXX X XXX X XXXXX XXX X X X XXXXXXX XXX XXX XXXXXXXXX XXXXX
X         X X   X       X X   X   X   X X   X X   X X         X X   X       X     X X   X       X X   X X X   X   X X X X     X X X X       X X X X X X X X X X X X   X   X X     X   X     X
XXXXX XXX X XXXXXXX XXXXX XXX XXXXXXXXXXXXX X XXX X XXX X X XXXXXXXXX XXXXXXXXXXX X XXX XXXXXXX X X XXX X X XXX XXXXXXX XXX X X X X X XXXXXXX X X XXX XXXXX XXX X X XXXXXXX X XXX XXX X XXXXX
X     X X X   X X   X       X       X   X X X       X   X X       X     X     X     X   X     X   X           X X   X       X   X   X X                         X       X X X   X         X X
X XXXXX X XXX X XXX X XXX X XXXXX X XXX X X X XXX XXXXX XXXXX XXXXXXXXX X X X X XXX X X XXXXX XXXXX XXXXXXXXX X XXX XXX XXXXXXX XXX X X XXXXX XXXXX XXXXXXXXXXXXXXXXX XXX X X XXXXXXX X XXX X
X     X   X X     X X X X X   X   X X       X   X     X X   X X   X X     X X X X X X X   X     X   X X     X X     X         X X   X       X   X       X       X         X   X X   X X X   X
XXXXXXXXXXX XXX X X X X XXXXX X XXXXX XXXXXXXXX XXXXX XXX XXX X XXX XXX XXX XXX X XXXXX XXXXXXX X X X X X XXX X XXXXXXXXXXXXX XXXXX X XXX XXXXX XXXXX XXX XXXXXXXXXXXXXXXXXXX X XXX X XXXXX X
X X X         X X         X X   X     X           X   X     X X X X     X   X X   X   X X     X   X X   X   X X X X     X       X     X   X     X X X         X X     X   X   X   X         X
X X XXX XXXXXXXXX X XXXXXXX XXXXXXX X X XXX XXXXXXXXX XXX X X X X XXXXX X XXX X XXX X XXXXXXX X XXX X XXXXXXXXX X X X X XXXXXXXXX XXXXX XXXXXXX X X XXX XXXXXXX X XXX X XXX XXXXX XXXXX XXXXX
X       X X       X X       X     X X X X   X   X X X   X X X X     X   X X   X X   X       X   X         X X   X   X X       X       X X     X X           X     X X           X       X   X
XXX XXXXX XXXXX X XXX XXX X X X XXX X XXX XXX X X X X XXX X XXXXX XXXXXXXXX XXXXX XXXXX X XXXXXXX X XXXXXXX XXX XXXXXXX XXX X X XXXXXXXXX XXXXXXXXXXXXXXX XXXXX XXX XXX XXXXXXXXXXXXXXX XXX X
X       X       X   X   X X   X   X X X X X   X     X     X   X X X X X X             X X   X   X X               X   X X X X X       X X           X   X     X X     X X X   X     X   X   X
X XXX XXXXX XXXXXXX XXX X X XXX XXX X X X XXXXXXX X X XXXXXXX X X X X X X XXXXXXXXX XXX X XXXXX X XXX XXX XXXXXXX X X XXX XXX XXX X X X XXXXXXXXX X XXX XXX X X XXX XXX X X X X XXXXXXXXX X X
X   X   X X X     X X X X X X X X X X       X   X X   X     X   X X X X X   X     X X   X       X   X   X X X     X X X         X X X       X X X X       X X X   X     X X X   X         X X
X XXXXXXX XXX XXX XXX XXXXXXX X X X X X X XXXXX X X XXXXX XXXXX X X X X XXX X XXXXXXXXXXXXX X XXXXXXX X XXX X XXXXXXX X XXX XXXXXXXXXXX XXXXX X X X XXX XXX X XXX XXX XXX XXXXX X X XXXXX XXX
X X X         X X X   X             X X X X   X   X     X X     X X   X   X           X   X X X   X   X X               X       X X X     X   X   X   X X   X       X   X         X X   X   X
X X XXXXXXX XXX X X XXXXXXX X XXXXXXXXXXX XXX XXXXXXXXXXX X XXX X X X X XXX X XXXXXXX XXX X XXX X XXXXX X XXXXXXXXX XXXXX XXXXXXX X X XXXXXXX X X XXX X X XXXXX X X XXX X XXX XXX XXX XXXXX X
X   X X       X X     X     X     X   X         X   X       X       X       X X X       X       X       X X X     X   X   X   X       X         X X   X   X     X X   X   X X X X X         X
XXX X X XXXXXXX X X X XXX XXXXXXX X XXX XXXXX XXXXX XXXXX XXXXXXXXX XXXXXXXXXXX X XXXXX X X XXXXXXXXXXX XXX X X X XXXXX X X X X XXXXXXX XXXXXXXXX XXX XXXXXXXXX X XXXXX X X X X X XXXXXXXXXXX
X         X       X X X X     X   X     X   X         X X X       X X X X     X     X   X X X         X X     X X X     X   X X X X X           X   X X         X X     X X   X     X X     X
X XXXXX XXX XXX XXXXXXX X XXX XXX XXX X X XXXXX X XXXXX X XXXXX X X X X XXX X XXXXXXX XXXXX X X X XXXXXXXXX XXX XXX XXXXXXXXX X X X X X X X XXXXXXXXX XXXXXXX X XXX XXXXXXXXX XXXXX X XXXXX X
X     X X   X               X   X   X X       X X   X     X     X           X   X       X     X X   X         X     X             X   X X X     X       X     X   X       X       X         X
XXXXXXXXXXXXXXXXXXXXXXXXXXXXXXXXXXXXXXXXXXXXXXXXXXXXXXXXXXXXXXXXXXXXXXXXXXXXXXXXXXXXXXXXXXXXXXXXXXXXXXXXXXXXXXXXXXXXXXXXXXXXXXXXXXXXXXXXXXXXXXXXXXXXXXXXXKXXXXXXXXXXXXXXXXXXXXXXXXXXXXXXXXXXX
